############################
E                          #
#####   ####################
#                          #
##################   #######
#                          S 
#############################