############################
E                          #
###################   ######
#                          #
#####   ####################
#                          S 
#############################
